1111111111
10000E1011
111T0C0P01
1C10011111
1111111111