1111111111
1C000010E1
10000P0C01
1PCTT10011
1111111111