111111111111
1C000010C0E1
1000001C0011
1PCTT000C0T1
111111111111