111111111111111
1C000010C010001
1000001C0010001
11CTT000C0T0101
1000C0000000101
1TP00000T0001E1
111111111111111