11111111111111111111
10000010001000C001E1
1CC00010001000101001
1C100010001000101001
10100010001000101001
1010001000C000101001
10100010001000101001
1P100010001000101001
1T1TT0CTTC1TTC10CT01
11111111111111111111