11111111111
1P0C000T0E0
11111111111